컴퓨터 시스템 : 데이터를 처리하는 물리적인 기계장치인 하드웨어와 어떤 작업을 지시하는 명령어로 작성한 프로그램인 소프트웨어로 구성

컴퓨터 하드웨어 : 하드웨어는 프로세서, 메모리, 주변장치로 구성되고 이들은 시스템 버스로 연결

사용자 가시 레지스터 : 사용자가 운용체제와 사용자 프로그램을 이용해 정보 변경 가능

- 데이터 레지스터 : 함수 연산에 필요한 데이터를 저장한다
- 주소 레지스터 : 주소나 유효 주소를 계산하는 데 필요한 주소의 일부분을 저장한다
	-기준 주소 레지스터
	-인덱스 레지스터
	-스택 포인터 레지스터

사용자 불가시 레지스터 : 사용자가 정보를 변경할 수 없는 레지스터이다. 프로세서의 상태와 제어를 관리

-프로그램카운터 PC : 다음에 실행할 명령어의 주소
-명령어 레지스터 IR : 현재 실행하는 명령어의 주소
-누산기 ACC : 데이터를 일시적으로 저장
-메모리 주소 레지스터 MAR : 데이터의 주소를 명시하여 메모리에 접근
-메모리 버퍼 레지스터 MBR : 메모리에서 읽거나 메모리에 저장할 데이터 자체를 보관하는버퍼

메모리 계층 구조 : 비싼 메인 메모리의 가격 문제 때문에 제안한 방법, 메모리를 계층적으로 구성하여 비용, 속도, 용량, 접근시간 등을 상호 보완
레지스터 -> 캐시 -> 메인메모리 -> 보조기억장치

레지스터 : 프로세서 내부에 있으며, 프로세서가 사용할 데이터를 보관하는 가장 빠른 메모리

메인 메모리 : 프로세서 외부에 있으면서 프로세서에서 수행할 프로그램과 데이터를 저장
-> 다수의 셀로 구성되며 각 비트로 구성, 한 개나 여러 개에 나눠서 저장
	메모리 맵핑 : 컴파일로 논리적 주소를 물리적 		      주소로 변경하는 과정

캐시 : 처리 속도가 빠른 프로세서와 상대적으로 느린 메모리의 속도 차이를 보완하는 고속 버퍼

캐시의 성능은 작은 용량의 캐시에 프로세서가 이후 참조할 정보가 얼마나 들어 있느냐로 좌우됨
캐시적중(히트) : 프로세서가 참조하려는 정보가 있을 때
캐시실패(미스) : 프로세서가 참조하려는 정보가 없을 때

지역성 - 지역성은 캐시 적중률과 밀접
공간적 지역성 : 대부분의 프로그램이 참조한 주소와 인접한 주소의 내용을 다시 참조하는 특성(순차적 프로그램 수행)
시간적 지역성 : 한 번 참조한 주소를 곧 다시 참조하는 특성(for문 등의 순환문)

발생원인 : 프로그램이 명령어를 순착적으로 실행하는 경향이 있어 명령어가 특정 지역에 메모리에 인접해 있다.

시스템 버스 : 하드웨어를 물리적으로 연결하여 서로 데이터를 주고 받을 수 있게 하는 통로
- 데이터버스 : 프로세서와 메인 메모리, 주변장치 사이에서 데이터를 전송
- 주소버스 : 프로세서가 시스템의 구성 요소를 식별하는 주소 정보를 전송
- 제어버스 : 프로세서가 시스템의 구성 요소를 제어하는 데 사용

주변장치 : 프로세서와 메인 메모리를 제외한 나머지 하드웨어 구성요소 (입력장치, 출력장치, 저장장치)

직접 주소와 간접 주소 : 
피연산자의 위치를 명시하는방법(직접주소 또는 간접 주소)을 나타내는 모드비트I를 추가하거나, 다음 명령어의 위치를 나타내는 주소를 추가 가능

직접 주소 : 피연산자에 데이터가 있는 레지스터나 메모리 주소 지정
간접 주소 : 레지스터나 메모리 주소 정보 지정

명령어의 실행 과정
명령어 인출 -> 명령어해석, 프로그램 카운터 변경 -> 피연산자 인출 -> 명령어 실행 -> 결과 저장 -> 다음 명령어로 이동